[
  {
    "type": "overmap_terrain",
    "id": [ "radio_tower_top_liminal" ],
    "vision_levels": "isolated_tower",
    "name": "radio tower",
    "sym": ".",
    "color": "light_gray",
    "see_cost": "all_clear"
  },
  {
    "type": "mapgen",
    "method": "json",
    "om_terrain": "radio_tower_top_liminal",
    "object": {
      "fill_ter": "t_metal_floor_no_roof",
      "rows": [
        "          g gg g        ",
        "          g gg g        ",
        "          g gg g        ",
        "gggggggggggggggggggggggg",
        "          g,,,,g        ",
        "ggggggggggg,RR,ggggggggg",
        "ggggggggggg,RX,ggggggggg",
        "          gv,,,g        ",
        "gggggggggggggggggggggggg",
        "          g gg g        ",
        "          g gg g        ",
        "          g gg g        ",
        "          g gg g        ",
        "          g gg g        ",
        "          g gg g        ",
        "          g gg g        ",
        "          g gg g        ",
        "          g gg g        ",
        "          g gg g        ",
        "          g gg g        ",
        "          g gg g        ",
        "          g gg g        ",
        "          g gg g        ",
        "          g gg g        "
      ],
      "palettes": [ "roof_palette" ],
      "terrain": {
        "R": "t_radio_tower",
        "X": [["t_radio_tower",90],["t_radio_tower_liminal_light",10]],
        "a": "t_railing",
        ",": "t_metal_floor_no_roof",
        "g": "t_grate",
        "*": "t_glass_roof"
      },
      "place_nested": [
        {
          "chunks": [ [ "null", 40 ], [ "mx_radio_tower_liminal_space", 5 ]],
          "x": 9,
          "y": 2
        }
      ]
    }
  },
  {
    "type": "mapgen",
    "method": "json",
    "weight":100,
    "nested_mapgen_id": "mx_radio_tower_liminal_space",
    "object": {
      "mapgensize": [ 8, 8 ],
      "rotation": [ 0, 3 ],
      "rows": [
        " cllllc ",
        "ctcllctc",
        "lcllllcl",
        "lllcclll",
        "lllCTlll",
        "lcllllcl",
        "ctcllctc",
        " cllllc "
      ],
      "terrain": {
      " ": "t_open_air",
      "l": "t_linoleum_white",
                    "c": "t_linoleum_white",
                    "C": "t_linoleum_white",
                    "t": "t_linoleum_white",
                    "T": "t_linoleum_whitefloor_slight_liminal",
                    "w":"t_wall_w",
                    "W":"t_wall_glass",
                    "d":[["t_door_glass_c",70],["t_door_glass_o",30]]
                    },
      "furniture":{
      "c":[["f_null",40],["f_chair",60]],
      "t":"f_table",
      "T":"f_counter",
      "C":"f_counter"
      },
      "items":{
        "t": { "item": "coffee_table", "chance": 25 },
        "C": { "item": "cash_register_random", "chance": 100 },
        "T": { "item": "coffee_counter", "chance": 20 }
      },
      "flags": [ "ERASE_ALL_BEFORE_PLACING_TERRAIN" ]
    }
  }
]
